{
    "width": 10,
    "height": 10,
    "tiles": [
        ["V","G","G","G","G","G","G","G","G","G"],
        ["G","G","G","G","G","G","G","G","A","G"],
        ["G","G","G","G","F","F","G","G","G","G"],
        ["G","G","G","F","F","F","F","G","G","G"],
        ["G","G","G","F","W","W","F","G","G","G"],
        ["G","G","G","F","W","W","F","G","G","G"],
        ["G","G","G","G","G","G","G","G","G","G"],
        ["G","G","R","G","G","G","G","G","G","G"],
        ["G","G","G","G","G","G","G","C","G","G"],
        ["G","G","G","G","G","G","G","G","G","G"]
    ],
    "startPosition": { "x": 1, "y": 1 }
}
